3
11 5
1 1 1 1 1 10 1 1 9 7 8
1 8 12 1 1 9 1 1 1 1 1
13 1 1 1 1 1 13 14 1 3 15 
12 1 7 2 1 1 1 10 1 1 14
1 1 1 1 1 1 1 1 15 0 0
12 3
1 21 1 
1 3 1 
1 1 13
1 1 19
18 1 1
67 1 1
1 1 1
1 1 15
13 1 18
15 1 1
1 67 2
19 21 1
12 12
15 1 1 26 31 1 66 1 24 12 1 1
61 17 2 7 1 1 1 1 1 14 1 1
1 1 8 1 1 32 34 1 41 1 1 1
55 1 1 1 1 1 1 1 15 1 71 1
71 1 67 22 1 1 9 8 1 1 86 1
1 1 1 66 1 1 1 1 1 1 1 1
18 22 1 1 1 55 43 1 1 31 1 1
1 1 41 33 1 1 1 1 47 3 1 1
73 47 1 1 34 7 1 1 1 1 26 61
1 12 9 1 1 1 1 1 67 1 1 1
24 1 1 1 1 86 1 14 1 1 32 1
55 1 18 17 1 33 1 73 1 1 43 1
